111111111111111111111111111111111111
100000000000000000000000000000000001
100000000000000000000000000000000001
100000000000000000000000000000000001
100000000000000001100000000000000001
100000000000000001100000000000000001
100000000000000001100000000000000001
100000000000000001100000000000000001
100000000000000000000000000000000001
100011000000000000000000000000110001
100001000000000000000000000000100001
100001000011110000000011110000100001
100001000011110000000011110000100001
100001000011110000000011110000100001
100001000000000000000000000000100001
100011000000000000000000000000110001
100000000000000000000000000000000001
100000000000000001100000000000000001
100000000000000001100000000000000001
100000000000000001100000000000000001
100000000000000001100000000000000001
100000000000000000000000000000000001
100000000000000000000000000000000001
100000000000000000000000000000000001
111111111111111111111111111111111111
