111111111111111111111111111111111111
100000000000000001100000000000000001
100000000000000001100000000000000001
100011111100000001100000001111110001
100000010000010001100010000010000001
100000010000010000000010000010000001
111100000000010000000010000000001111
100000000000000000000000000000000001
100000000000000000000000000000000001
100000000011110000000011110000000001
100011110000010000000010000011110001
100000000000010000000010000000000001
100000000100000000000000001000000001
100000000100000000000000001000000001
100111000000000000000000000000111001
100001000000100000000001000000100001
100001000000100001100001000000100001
100000000000110000000011000000000001
100000000000000000000000000000000001
100000010000000000000000000010000001
100000010000000001100000000010000001
100000010000000001100000000010000001
100000010000000001100000000010000001
100000010000000001100000000010000001
111111111111111111111111111111111111
